

NO ./textures/wall_1.xpm
SO ./textures/wall_2.xpm
WE ./textures/wall_3.xpm
EA ./textures/wall_4.xpm

F 153, 204, 255
C 0, 76, 153


1111111111
1N00000001
1011111101
1011001101
1011001101
1111111111
1        1
1111111111
1011011101
1000000001
1111111111



