NO ./textures/north
SO ./textures/south.xpm
WE ./textures/west.xpm
EA ./textures/east.xpm

F 220,100,0
C 225,30,0

1111111111111111111111111111
10000000001100000000000011111
1011000001110000000000001   11
10010000000000000000000011111111
111111111011000001110000000000001
10000000001110000111011111111111
11110111111 11011100000010001
11110111111111011101010010001
11000000110101011100000010001
10000000000000001100000010001
10000000000000001101010010001
11000001110101011111011110N0111
11110111 1110101 101111010001
11111111 111111  11111111111